021
001
1111111111
1111111111
1111111111
1111111111
1111111111
1111111111
1111111111
1111111111
1111111111
1111111111
002
1111111111
1111111111
1111111111
1111111111
1110000111
1110000111
1111111111
1111111111
1111111111
1111111111
003
0111001110
0111001110
0111001110
0111001110
0111001110
0111001110
0111001110
0111001110
0111001110
0111001110
004
0000000000
0000000000
0000000000
0000000000
0000000000
0000000000
0000000000
0000000000
0000000000
0000000000
005
0000001110
0000001110
0000001110
0000001110
0000001110
0000001110
0000001110
0000001110
0000001110
0000001110
006
0111000000
0111000000
0111000000
0111000000
0111000000
0111000000
0111000000
0111000000
0111000000
0111000000
007
0001111000
0001111000
0001111000
0001111000
0001111000
0001111000
0001111000
0001111000
0001111000
0001111000
008
1111100000
1111100000
1111100000
1111100000
1111100000
1111100000
1111100000
1111100000
1111100000
1111100000
009
0000011111
0000011111
0000011111
0000011111
0000011111
0000011111
0000011111
0000011111
0000011111
0000011111
010
0001111000
0001111000
0001111000
0001111000
0001111000
0001111000
0001111000
0001111000
0001111000
0001111000
011
1100000011
1100000011
1100000011
1100000011
1100000011
1100000011
1100000011
1100000011
1100000011
1100000011
012
1100000000
1100000000
1100000000
1100000000
1100000000
1100000000
1100000000
1100000000
1100000000
1100000000
013
0001100000
0001100000
0001100000
0001100000
0001100000
0001100000
0001100000
0001100000
0001100000
0001100000
014
0000011000
0000011000
0000011000
0000011000
0000011000
0000011000
0000011000
0000011000
0000011000
0000011000
015
0000000011
0000000011
0000000011
0000000011
0000000011
0000000011
0000000011
0000000011
0000000011
0000000011
016
1100011000
1100011000
1100011000
1100011000
1100011000
1100011000
1100011000
1100011000
1100011000
1100011000
017
0001100011
0001100011
0001100011
0001100011
0001100011
0001100011
0001100011
0001100011
0001100011
0001100011
018
1111111000
1111111000
1111111000
1111111000
1111111000
1111111000
1111111000
1111111000
1111111000
1111111000
019
0001111111
0001111111
0001111111
0001111111
0001111111
0001111111
0001111111
0001111111
0001111111
0001111111
020
1100011111
1100011111
1100011111
1100011111
1100011111
1100011111
1100011111
1100011111
1100011111
1100011111
021
1111100011
1111100011
1111100011
1111100011
1111100011
1111100011
1111100011
1111100011
1111100011
1111100011
